size.x=20
size.y=20
room.base=29200
room.max=99
zone.name=Mirk Maze 292
zone.symbol=*
zone.x=12
zone.y=7
zone.nr=292
zone.lifespan=10
source.wld=../lib/world/wld/266.wld
source.zon=../lib/world/zon/266.zon
output.wld=../lib/world/wld/292.wld
output.zon=../lib/world/zon/292.zon
~
@5 6 26696 0
@4 5 26696 1
@6 5 26696 3
!5 4
!5 5
s5 4 E
s5 5 X
~
#Entrance connector
26694 0  0  2 2 2 2

#Mirkwolves
26611 0  0  2 0 1 0
26612 -1 1  0 1 0 2
26613 0  2  1 0 2 0
26614 1  1  2 0 0 1
26615 0  1  1 1 1 1

#Ants
26629 0  0  2 2 1 2
26630 0  1  1 0 0 0

#Spinners
26621 0  0  2 0 1 0
26622 0  1  1 1 0 0
26623 1  1  0 2 0 1

#Trapdoor
26624 0  0  0 1 1 0
26625 1  0  0 2 0 1
26626 0  1  1 0 2 0

#Wychelms
26631 0  0  2 0 1 0
26632 -1 1  0 1 0 2
26633 0  2  1 0 2 0
26634 1  1  2 0 0 1
26635 0  1  1 1 1 1

#Guldulin
26640 0  0  0 0 1 0
26638 -1 1  0 1 0 2
26642 0  2  1 0 0 0
26641 1  1  2 0 0 1
26639 0  1  1 1 1 1

#Long Barrow I
26654 0  0  2 1 1 0
26655 0  1  1 1 0 0
26656 1  0  0 0 1 1
26657 1  1  1 0 0 1

#Long Barrow II
26658 0  0  0 1 1 2
26659 1  0  0 0 1 1
26660 1  1  1 0 0 1
26661 0  1  1 1 0 0

#Long Barrow III
26662 0  0  0 1 0 2
26663 1  0  0 0 1 1
26664 1  1  1 0 0 0

#Hazels
26665 0  0  2 0 1 0
26666 0  1  1 0 2 0

#Gnarled Chestnuts
26673 0  0  0 1 0 2
26674 1  0  0 1 0 1
26675 2  0  0 2 0 1

#Boar
26637 0  0  2 0 0 0

#Sassafras
26648 0  0  2 0 1 0
26649 -1 1  0 1 0 0
26650 0  2  1 0 2 0
26651 1  1  0 0 0 1
26652 0  1  1 1 1 1
