size.x=10
size.y=10
room.base=28100
room.max=99
zone.name=Mirk Maze 281
zone.symbol=*
zone.x=14
zone.y=7
zone.nr=281
zone.lifespan=10
source.wld=../lib/world/wld/266.wld
source.zon=../lib/world/zon/266.zon
output.wld=../lib/world/wld/281.wld
output.zon=../lib/world/zon/281.zon
~
@5 6 26600 0
@4 5 26600 1
@6 5 26600 3
!5 4
!5 5
s5 4 E
s5 5 X
~
#Entrance connector
26694 0  0  2 2 2 2

#Plane
26636 0  0  2 2 2 2

#RedwoodsI
26601 0  0  2 0 1 0
26602 0  1  1 0 2 0

#RedwoodsII
26603 0  0  2 0 0 0

#RedwoodsIII
26604 0  0  2 0 1 0
26605 0  1  1 0 1 0
26606 0  2  1 0 2 0

#Wildsilk
26607 0  0  2 0 0 0

#Mirkwolves
26611 0  0  2 0 1 0
26612 -1 1  0 1 0 2
26613 0  2  1 0 2 0
26614 1  1  2 0 0 1
26615 0  1  1 1 1 1

#Spinners
26621 0  0  2 0 1 0
26622 0  1  1 1 0 0
26623 1  1  0 2 0 1

#Trapdoor
26624 0  0  0 1 1 0
26625 1  0  0 2 0 1
26626 0  1  1 0 2 0

#Bears
26627 0  0  2 2 1 2
26628 0  1  1 0 0 0

#Ants
26629 0  0  2 2 1 2
26630 0  1  1 0 0 0

#Wychelms
26631 0  0  2 0 1 0
26632 -1 1  0 1 0 2
26633 0  2  1 0 2 0
26634 1  1  2 0 0 1
26635 0  1  1 1 1 1

#Guldulin
26640 0  0  0 0 1 0
26638 -1 1  0 1 0 2
26642 0  2  1 0 0 0
26641 1  1  2 0 0 1
26639 0  1  1 1 1 1

#Rookey
26643 0  0  2 2 1 2
26644 0  1  1 0 0 0

#Blackoak
26645 0  0  0 0 0 2

#Raven
26646 0  0  2 2 1 2
26647 0  1  1 0 0 0

#Scarlet Oaks
26653 0  0  2 2 2 2

#Long Barrow I
26654 0  0  2 1 1 0
26655 0  1  1 1 0 0
26656 1  0  0 0 1 1
26657 1  1  1 0 0 1

#Long Barrow II
26658 0  0  0 1 1 2
26659 1  0  0 0 1 1
26660 1  1  1 0 0 1
26661 0  1  1 1 0 0

#Long Barrow III
26662 0  0  0 1 0 2
26663 1  0  0 0 1 1
26664 1  1  1 0 0 0

#Hazels
26665 0  0  2 0 1 0
26666 0  1  1 0 2 0

#Ancient Elder
26667 0  0  0 0 2 0

#Gnarled Chestnuts
26673 0  0  0 1 0 2
26674 1  0  0 1 0 1
26675 2  0  0 2 0 1
