size.x=10
size.y=10
room.base=23700
room.max=99
zone.name=Orcish maze level 3
zone.symbol=*
zone.x=21
zone.y=6
zone.nr=237
zone.lifespan=10
source.wld=../lib/world/wld/107.wld
source.zon=../lib/world/zon/107.zon
output.wld=../lib/world/wld/237.wld
output.zon=../lib/world/zon/237.zon
~
@5 4 10702 2
@5 6 10702 0
@4 5 10702 1
@6 5 10702 3
!5 5
s5 5 V
~
#Burrow
10740  0  0  2 2 2 2

#Grotto
10720  0  0  2 2 1 2
10721  0  1  1 0 0 0

#Red Cave
10723  0  0  1 2 0 1
10724 -1  0  0 1 0 0
10725  0 -1  0 2 1 2

#Great Cave
10726  0  0  1 2 1 1
10727  0 -1  2 0 1 2
10728  0  1  1 0 0 0
10744 -1  0  0 1 0 0

#Underground Lake
10730  1  0  1 1 0 1
10731  1 -1  0 0 1 0
10732  0  0  2 1 2 2
10729  2  0  0 0 0 1

#Storage Room
10733  -1 0  0 1 0 0
10734  0  0  0 2 0 1


#Collapsed Tunnel
10786  0  0  0 1 0 2
10787  1  0  0 1 0 1
10789  2  0  0 2 0 1

#Collapsed Tunnel
10786  0  0  2 1 0 2
10787  1  0  0 1 0 1
10789  2  0  0 2 2 1

#Disgusting Tunnel1
10790  0  0  2 0 2 0

#Disgusting Tunnel2
10790  0  0  0 2 0 2

#Housing
10796  0  0  2 2 1 2
10735  0  1  1 1 1 0
10736  1  1  0 0 1 1
10737  0  2  1 0 0 0

#Miner Tunnel 1
10782  0  0  2 2 1 2
10781  0  1  1 0 1 0
10780  0  2  1 2 1 2
10779  0  3  1 2 2 2

#Miner Tunnel 2
10782  0  0  2 1 2 2
10781  1  0  0 1 0 1
10780  2  0  2 1 2 1
10779  3  0  2 2 1 2

#Mine
10743  0  0  2 1 2 2
10741  1  0  0 2 1 1
10742  1  1  1 0 0 0

#Flooded Cave
10745  0  0  2 0 2 1
10747 -1  1  1 0 0 0
10746 -1  0  0 1 1 1
10748 -2  0  0 1 0 0

#Vortex
10749  0  0  2 2 1 2
10750  0  1  1 0 1 0
10751  0  2  1 0 0 1
10752 -1  2  1 1 0 0
10753 -1  1  0 0 1 0

#Flooded Tunnel
10754  0  0  2 0 2 0

#10 2 Flooded Tunnel
10754  0  0  0 2 0 2

#Stagnant end
10783  0  0  2 1 2 2
10784  1  0  1 0 0 1
10785  1 -1  0 0 1 0

#Cave of wonders
10766  0  0  2 1 1 2
10767  1  0  0 1 0 1
10768  2  0  0 2 1 1
10769  0  1  1 1 1 2
10770  1  1  0 1 0 1
10771  2  1  1 2 2 1
10772  0  2  1 0 2 2

#corroded tunel
10775  0  0  2 1 0 0
10774  1  0  0 0 1 1
10773  1  1  1 0 2 0

#River
10776  0  0  1 2 2 2
10777  0 -1  0 1 1 0
10778  1 -1  0 2 0 1

#pool 1
10792  0  0  2 1 1 2
10793  1  0  0 2 1 1
10794  1  1  1 2 2 1
10795  0  1  1 1 2 2

#pool 2
10792 -1  0  2 1 1 2
10793  0  0  0 2 1 1
10794  0  1  1 2 2 1
10795 -1  1  1 1 2 2

#pool 3
10792 -1 -1  2 1 1 2
10793  0 -1  0 2 1 1
10794  0  0  1 2 2 1
10795 -1  0  1 1 2 2


#0
